TILEMAP
97 30 							-- Size of tile map in tiles
32 32							-- Tile size & block size
images/Sprite-0001.png 	-- Tilesheet
2 2 								-- Number of tiles in tilesheet
11                                                                                             11
11                                                                                             11
11                                                                                             11
11                                                                                             11
11                                                                                             11
11                                                                                             11
11                                                                                             11
11                                                                                             11
11                                                                                             11
11                                                                                             11
11                                                                                             11
11                                                                                             11
11                                                                                             11
11                                                                                             11
11                                                                                             11
11                                                                                             11
11                                                                                             11
11                                                                                             11
11                                                                                             11
11                                                                              44444444       11
11                                                     444444                   11111111       11
11                                                    41    14                441111111144     11
11                                                          114               111111111111     11
11                                    444                   1114              111111111111     11
11             444444444             41114                  11114             111111111111     11
114444444444444111111111     44444444111114      444444444241111144444444244441111111111114444411
111111111111111111111111     11111111111111444444111111111211111111111111211111111111111111111111
1111111111111111111111113333311111111111111111111111111111211111111111111211111111111111111111111
1111111111111111111111113333311111111111111111111111111111211111111111111211111111111111111111111
1111111111111111111111111111111111111111111111111111111111211111111111111211111111111111111111111